#E###
#   #
# # #
#  ##
#   #
###^#