#E########
#       E
#      ###
#      #
#      ##
#       ^
#########