#E######
#      #
#  #####
#  #   #
#  #   #
#      #
#####^##