#^###
#   #
# # #
#  ##
#   #
###E#